###@@@###%%%&&&###%%%
###@@@###%%%&&&###%%%
###@@@###%%%&&&###%%%
@@@###%%%@@@###&&&@@@
@@@###%%%@@@###&&&@@@
@@@###%%%@@@###&&&@@@
%%%@@@&&&###&&&###&&&
%%%@@@&&&###&&&###&&&
%%%@@@&&&###&&&###&&&
&&&###%%%@@@%%%&&&%%%
&&&###%%%@@@%%%&&&%%%
&&&###%%%@@@%%%&&&%%%