#&##%&#@#@&@%&@#&##@#&%&#@%%@#&%#@&%%@%
&&&#%%@#&#@@#%%&&#@@@&%&%%%%@#&%&@&&%&@
##&%%%%@&&&%###%%&&#%%%%@@@@@#%&@#%%%##
@@@@@@####&%%##%%&&###@#&@&#@%%%%%@@@##
@@####&&&&&%%%%%&#&@&#&#%%%%&&@#@#&%&#&
#%@&@@%&%#%%#%#%#&@&#&@@@@#&####&&&@#@%
&&&%%%&&&&&%%#########&#&#&@@@@&###@&@&
&#&%%%%%#@@@@@@@#####@#@###&&&&&###@@@#
#@#@#@############@@@@@@@@@#######@@###
@@@@@@@@%%%%%%%%%%%%%%@@@@@@@@@@@@@####
&&&&&&@@@@@@@@@@@@@@%%%%%%%%#%#@#@#%#%%
@#&@#&@#%&#%@&#%#@&#%#@&#%%#&@&@&#%%%#&
&&&###&&&%%%#@@@&&&###&&@@@%%@%%%@@@&&&
&&######%%%%########@@@@@%%%@@@@&&&&&&&
&%#@#@#@&&#&&&&&##@@&###&&@@@@@&&&&@@@@